A########################################
Bs_#____________#________#______________#
C__#____________#________#______________#
D__#__#_________#________#______________#
E__#__#_________#________#______________#
F__#__#_________#________#______________#
G__#__#_________#________#______________#
H__#__#_________#________#______________#
I__#__#_________##########______________#
J_____#________________________________f#
K########################################