!LVL1
########################################
#s #            #        #             #
#  #            #        #             #
#  #  #         #        #             #
#  #  #         #        #             #
#  #  #         #        #             #
#  #  #         #        #             #
#  #  #         #        #             #
#  #  #         ##########             #
#     #                               f#
########################################