A########################################
Bs #            #        #              #
C  #            #        #              #
D  #  #         #        #              #
E  #  #         #        #              #
F  #  #         #        #              #
G  #  #         #        #              #
H  #  #         #        #              #
I  #  #         ##########              #
J     #                                f#
K########################################